4444444114444444
4000000000000004
4000000000000004
4000000000000004
1000000000000001
4000000000000004
4000000000000004
4000000000000004
4444444114444444
